type octile
height 98
width 98
map
TTTTTTTTTTTTTTTTTTTTTTTTTTTTTTTTTTTTTTTTTTTTTTTTTTTTTTTTTTTTTTTTTTTTTTTTTTTTTTTTTTTTTTTTTTTTTTTTTT
TTTTTTTTTTTTTTTTTTTTTTTTTTTTTTTTTTTTTTTTTTTTTTTTTTTTTTTTTTTTTTTTTTTTTTTTTTTTTTTTTTTTTTTTTTTTTTTTTT
TTTTTT........................TTTTTTTT..TTTTTT......TTTTTTTT..TTTTTTTT........................TTTT
TTTTTT........................TTTTTTTT..TTTTTT......TTTTTTTT..TTTTTTTT........................TTTT
TTTT..........................TTTTTT................TTTTTT....TTTTTT..........................TTTT
TTTT..........................TTTTTT................TTTTTT....TTTTTT..........................TTTT
TT..............................................................................................TT
TT..............................................................................................TT
TT..............................................................................................TT
TT..............................................................................................TT
TT..............................................................................................TT
TT..............................................................................................TT
TT..............................................................................................TT
TT..............................................................................................TT
TT..............................................TTTT............................................TT
TT..............................................TTTT............................................TT
TT............................................TTTTTT............................................TT
TT............................................TTTTTT............................................TT
TT............................................TTTTTT............................................TT
TT............................................TTTTTT............................................TT
TT..............................................................................................TT
TT..............................................................................................TT
TT..............................................................................................TT
TT..............................................................................................TT
TT..............................................................................................TT
TT..............................................................................................TT
TT..............................................................................................TT
TT..............................................................................................TT
TT..............................................................................................TT
TT..............................................................................................TT
TTTTTT........................TTTTTTTT........................TTTTTTTT........................TTTT
TTTTTT........................TTTTTTTT........................TTTTTTTT........................TTTT
TTTTTT........................TTTTTTTT........................TTTTTTTT........................TTTT
TTTTTT........................TTTTTTTT........................TTTTTTTT........................TTTT
TTTTTT........................TTTTTTTT........................TTTTTTTT........................TTTT
TTTTTT........................TTTTTTTT........................TTTTTTTT........................TTTT
TTTT..........................TTTTTT..........................TTTTTT..........................TTTT
TTTT..........................TTTTTT..........................TTTTTT..........................TTTT
TTTT............................................................................................TT
TTTT............................................................................................TT
TTTT............................................................................................TT
TTTT............................................................................................TT
TTTT............................................................................................TT
TTTT............................................................................................TT
TTTT............................................................................................TT
TTTT............................................................................................TT
TT..............................................................................................TT
TT..............................................................................................TT
TT..............................................................................................TT
TT..............................................................................................TT
TT..............................................................................................TT
TT..............................................................................................TT
TTTT............................................................................................TT
TTTT............................................................................................TT
TTTTTT..........................................................................................TT
TTTTTT..........................................................................................TT
TTTTTT..........................................................................................TT
TTTTTT..........................................................................................TT
TTTTTT..........................................................................................TT
TTTTTT..........................................................................................TT
TT..............................................................................................TT
TT..............................................................................................TT
TTTTTT........................TTTTTTTT........................TTTTTTTT........................TTTT
TTTTTT........................TTTTTTTT........................TTTTTTTT........................TTTT
TTTTTT........................TTTTTTTT........................TTTTTTTT........................TTTT
TTTTTT........................TTTTTTTT........................TTTTTTTT........................TTTT
TTTTTT........................TTTTTTTT........................TTTTTTTT........................TTTT
TTTTTT........................TTTTTTTT........................TTTTTTTT........................TTTT
TTTT..........................TTTTTT..........................TTTTTT..........................TTTT
TTTT..........................TTTTTT..........................TTTTTT..........................TTTT
TT..............................................................................................TT
TT..............................................................................................TT
TT..............................................................................................TT
TT..............................................................................................TT
TT..............................................................................................TT
TT..............................................................................................TT
TT..............................................................................................TT
TT..............................................................................................TT
TT..............................................................................................TT
TT..............................................................................................TT
TT..............................................................................................TT
TT..............................................................................................TT
TT..............................................................................................TT
TT..............................................................................................TT
TT..............................................................................................TT
TT..............................................................................................TT
TT..............................................................................................TT
TT..............................................................................................TT
TT..............................................................................................TT
TT..............................................................................................TT
TT..............................................................................................TT
TT..............................................................................................TT
TT......................................TTTTTT......TTTTTT......................................TT
TT......................................TTTTTT......TTTTTT......................................TT
TTTTTT........................TTTTTTTT..TTTTTTTT....TTTTTTTT..TTTTTTTT........................TTTT
TTTTTT........................TTTTTTTT..TTTTTTTT....TTTTTTTT..TTTTTTTT........................TTTT
TTTTTTTTTTTTTTTTTTTTTTTTTTTTTTTTTTTTTTTTTTTTTTTTTTTTTTTTTTTTTTTTTTTTTTTTTTTTTTTTTTTTTTTTTTTTTTTTTT
TTTTTTTTTTTTTTTTTTTTTTTTTTTTTTTTTTTTTTTTTTTTTTTTTTTTTTTTTTTTTTTTTTTTTTTTTTTTTTTTTTTTTTTTTTTTTTTTTT
